State,Year,Utility,Design,Plant,Reissue,Total,SIRS
DC,1996,40,2,0,0,42,0
DC,1997,52,7,0,0,59,0
DC,2001,67,5,0,1,73,0
DC,2002,61,4,0,0,65,0
DC,2003,49,1,0,0,50,0
DC,2004,75,5,0,0,80,0
DC,2005,55,4,0,0,59,0
DC,2006,63,6,0,0,69,0
DC,2007,63,8,0,0,71,0
DC,2008,68,3,0,0,71,0
DC,2009,57,4,0,1,62,0
DC,2010,82,5,0,0,87,0
DC,2011,97,4,0,1,102,0
DC,2012,131,17,0,0,148,0
DC,2013,133,8,0,0,141,0
DC,2014,161,10,0,0,171,0
