State,Year,Utility,Design,Plant,Reissue,Total,SIRS
WY,1992,34,0,0,0,34,0
WY,1993,35,8,0,0,43,0
WY,1994,41,11,0,0,52,0
WY,1995,50,26,0,0,76,0
WY,1996,33,12,0,0,45,0
WY,1997,51,9,0,0,60,0
WY,1998,45,4,0,0,49,0
WY,1999,52,6,0,0,58,0
WY,2000,55,12,0,0,67,0
WY,2001,51,7,0,1,59,0
WY,2007,54,8,0,0,62,0
WY,2008,35,6,0,0,41,0
WY,2009,59,5,0,0,64,0
WY,2010,82,7,0,0,89,0
WY,2011,65,8,0,1,74,0
WY,2012,120,5,0,0,125,0
WY,2013,113,20,0,1,134,0
WY,2014,122,8,0,1,131,0
WY,2015,110,4,0,0,114,Not Provided
